30
KAI: MYC; ELO; CQT; OTT; GPS; BSB; PNZ; OLC; MVF; CSZ; APQ; KAI;
GYN: OTT; GPS;
CSZ: ELO;
OLC: BVL; MYC; OTT; MEA; ZRZ; RAF; APQ; PSO; ELO;
AHL: BSB; AYA; MYC; GSI; PDU; CQT; PSO; CRC; KAI; CSZ; OTT; MVF; MRR; AHL;
MVF: GPS;
PZA: KAI; CQT;
MRR: BVL;
BVL: CRC; MEA; MGN; AYA;
CRC: GPS;
PNZ: CSZ;
MGN: ELO; CQT; MVF; UDI; CSZ;
MEA: PNZ; CRC; MYC; UDI; BRA; OLC; MEA;
UDI: PSO;
PDU: APQ;
BSB: GSI;
MYC: AYA;
CQT: AHL; MVF; RAF; BVL; CQT;
PSO: AHL;
GSI: KAI; ELO;
OTT: PDU; MEA; GYN;
CCH: AHL;
RAF: GYN;
PVH: MEA;
BRA: CQT;
GPS: CSZ; CCH; PNZ; GPS; ELO; AHL; RAF;
ZRZ: APQ;
APQ: APQ; MYC;
AYA: PDU;
ELO: OTT;
1
